#,#,#,#,#,#
#,0,H,0,0,#
#,#,0,0,#,#
#,#,0,0,#,#
#,#,#,0,T,#
#,#,#,#,#,#