#,#,#,#,#,#,#,#,#,#,#,0,0,#,#,#,#
#,#,#,0,0,0,#,0,0,0,0,0,#,#,0,#,#
#,#,0,H,#,#,0,0,0,#,0,0,0,0,0,0,#
#,#,0,#,#,0,0,0,0,0,0,0,0,0,0,0,#
#,#,0,#,0,0,0,#,0,0,0,0,0,0,0,0,#
#,#,0,#,0,0,0,#,#,0,#,#,#,#,#,#,#
#,0,0,0,0,0,0,0,0,#,0,0,#,#,#,#,#
#,#,#,#,#,0,0,#,0,0,0,0,#,#,#,#,#
#,#,#,0,0,0,0,0,0,#,#,#,#,#,#,#,#
#,#,#,0,0,0,0,#,#,0,0,0,0,0,0,0,#
#,0,0,#,0,0,0,0,0,#,0,#,0,#,#,0,#
#,0,0,#,0,0,0,#,0,#,0,0,0,0,#,#,#
#,0,#,0,0,0,0,#,0,#,0,0,0,0,0,0,#
#,#,#,0,0,0,0,#,0,0,0,#,#,#,#,#,#
#,0,#,T,0,0,0,0,0,0,0,0,0,0,0,0,#
#,#,#,0,#,0,#,#,0,0,0,0,0,#,0,#,#
#,#,#,#,#,#,#,#,#,#,#,#,#,#,#,#,#